00000000010000010000000010110011 add
01000000010000010000000010110011 sub
00000000010000010001000010110011 
00000000010000010010000010110011
00000000010000010011000010110011
00000000010000010100000010110011
00000000010000010101000010110011
01000000010000010101000010110011
00000000010000010110000010110011
00000000010000010111000010110011


i type

01000000010000010000000010010011
00000000010000010001000010010011
00000000010000010010000010010011
00000000010000010011000010010011
00000000010000010100000010010011
00000000010000010101000010010011
01000000010000010101000010010011
00000000010000010110000010010011
00000000010000010111000010010011



J type

00000000010000010000000010110011
00000000100000000000001111101111
01000000010000010000000010110011
00000000010000010000010010110011



U type

00000000000000000000000000010011
00000000000000000001000010010111


B type 

00000000010000010000000010110011
00000000010000010000011001100011
01000000010000010000000010110011
00000000010000010000010010110011



S type

00000000010000010000000010100011


L type 

00000000000100010000011000000011        LB

00000000000100010100011010000011        LBU


example instrction 
0000000 00001 00010 100 00001 0010011
